The living room of the Victorian mansion buzzed with chatter, the clinking of glasses, and the enchanting voice of a singer filling the air. After all, a New Year's Eve party like this was a rare occasion.

When the clock struck midnight, fireworks illuminated the sky outside, and the guests erupted into cheers of "Happy New Year!" The sound of toasts and laughter echoed throughout the room.

Moments later, the lights flickered back on, and an eerie silence replaced the joyful music. Gasps and murmurs spread as all eyes fell on the lifeless body of Simon the chipmunk sprawled on the carpet, blood pooling around him.

Duck-tective burst dramatically into the room, his detective hat slightly askew. You followed close behind.

"It appears," he quacked with flair, "we have a MURDER on our hands!"

He pointed a feathery wing at the scene. "Apprentice! This is your moment. Search the mansion, gather evidence, interrogate the suspects, and do whatever it takes to crack this case. This is your final test to earn your badge as a true detective!"

With a sly grin, Duck-tective added, "Of course, I already know who the culprit is. If you find yourself lost, you may consult me... but only if you wish me to question your capabilities. Now go forth and question the suspects-quack, quack!"

**INFORMATION FOR THE PLAYER**

You can guess the murderer when you find all the clues. If you know to which character the clue is tied to, you can ask that character about it. For neutral clues like keys and chests, ask Duck-tective for help.

Try looking inside or behind the items you see in every room.

If you want to try guessing the killer before finding all the clues type "guess (suspect)" - this will, however, end the game

>examine map
N
                                                 
                                Simon's room        Library
                                            |                        |
                                            |                        |
                                     Small Hall ------ Living Room ---- Terrace
 W                                        |                                                                        E 
                                            |                         
                  Garden ----Grand Hall --- Dining Room ------ Kitchen
                                            |                       |
                                            |                       |
                               Main Entrance     Staff Room
                                          
                                                         S

>n
Small Hall
A narrow passageway connecting the rooms upstairs, the small hall is dimly lit, with worn rugs lining the floor. A faint scuff mark on the wall catches your attention, its origin unknown but undoubtedly suspicious.

From here you can go east to the Living Room, north to enter Simon's room or south down the stairs to the Grand Hall.

>e
Living room
This is the room where it happened. Though the police have removed the body, the faint metallic scent of blood still lingers in the air. The grand furniture and ornate decor now feel cold and uninviting, as if the room itself remembers the crime.

From here you can go north to the Library, west to the Small Hall or east to get to the Terrace.

You can see Duck-tective and a mushroom here.

>examine mushroom
A red and white mushroom, as big as a dog's head, yet as light as a feather. What purpose could it possibly serve?

>eat mushroom
You munch down the mushroom. A burst of energy fills you up. Strange...

I beg your pardon?

>w
Small Hall
A narrow passageway connecting the rooms upstairs, the small hall is dimly lit, with worn rugs lining the floor. A faint scuff mark on the wall catches your attention, its origin unknown but undoubtedly suspicious.

From here you can go east to the Living Room, north to enter Simon's room or south down the stairs to the Grand Hall.

>e
Living room
This is the room where it happened. Though the police have removed the body, the faint metallic scent of blood still lingers in the air. The grand furniture and ornate decor now feel cold and uninviting, as if the room itself remembers the crime.

From here you can go north to the Library, west to the Small Hall or east to get to the Terrace.

You can see Duck-tective and a mushroom here.

* * *

>look at map
N
                                                 
                                Simon's room        Library
                                            |                        |
                                            |                        |
                                     Small Hall ------ Living Room ---- Terrace
 W                                        |                                                                        E 
                                            |                         
                  Garden ----Grand Hall --- Dining Room ------ Kitchen
                                            |                       |
                                            |                       |
                               Main Entrance     Staff Room
                                          
                                                         S

>take map
Taken.

* * *

>n
Small Hall
A narrow passageway connecting the rooms upstairs, the small hall is dimly lit, with worn rugs lining the floor. A faint scuff mark on the wall catches your attention, its origin unknown but undoubtedly suspicious.

From here you can go east to the Living Room, north to enter Simon's room or south down the stairs to the Grand Hall.

>e
Living room
This is the room where it happened. Though the police have removed the body, the faint metallic scent of blood still lingers in the air. The grand furniture and ornate decor now feel cold and uninviting, as if the room itself remembers the crime.

From here you can go north to the Library, west to the Small Hall or east to get to the Terrace.

You can see Duck-tective here.

>e
terrace
The terrace offers a breathtaking view of the garden below, though the cold night air seems to carry a sense of unease. Elegant wrought-iron furniture is neatly arranged, yet a single chair is overturned, hinting at a moment of panic or a hurried escape.

From here you can go west to the Living room.

* * *

>w
Garden
The garden is pristine, every bush and flower meticulously arranged to perfection, as if prepared for a royal visit. Strings of fairy lights drape from tree to tree, casting a soft, golden glow over the vibrant blooms. The scent of roses and freshly mowed grass lingers in the crisp night air. A majestic fountain sparkles at the center, but nearby, a once-proud marble sculpture lies shattered on the ground, its pieces scattered like a puzzle. The damage looks fresh, and the footprints leading away suggest someone was here-and left in a hurry.

From here you can go east to go to the Grand Hall.

You can see a rose chest (closed) and a rose bush here.

* * *

>take map
Taken.

>look at map
N
                                                 
                                Simon's room        Library
                                            |                        |
                                            |                        |
              Small Hall ------ Living Room ---- Terrace
 W                                        |                                                                        E 
                                            |                         
                  Garden ----Grand Hall --- Dining Room ------ Kitchen
                                            |                       |
                                            |                       |
                               Main Entrance     Staff Rooms
                                          
                                                         S

* * *

>interrogate Mario
Mario seems nervous but shares what he knows.

* * *

>interrogate smurfette
I would NEVER hurt anyone! I'm a SMURF for Smurf's sake! And on top of that, I'm Simon's SMURFriend! We've been dating for 2 SMURFTASTIC years, and he was an absolute gem! Oh-OH SIMON!!! starts crying How could anyone be so cruel? I bet it was Gargamel! That evil wizard must've put a spell on someone to do his SMURFY dirty work! sniffs dramatically

>interrogate sponge
You can't see any such thing.

>interrogate spongebob
Haha! Chipmunk?? What chipmunk? I have NEVER seen one in my life! OH SIMON THE CHIPMUNK! Of course I know Simon! He was always hanging around the Krusty Krab... you know, trying to sneak free Krabby Patties! Why do you ask?...... NO, I'M NOT HIDING ANYTHING!! YOU'LL NEVER CATCH ME ALIVE! runs away, slipping on some butter

* * *

>n
dining room
The dining room exudes grandeur, with a long, polished oak table set for a feast that never came. Ornate chairs, upholstered in rich velvet, are carefully arranged around it, though one seems hastily pushed back, as if someone stood up abruptly. Crystal chandeliers hang from the ceiling, their glow reflecting off fine china and silverware.

From here you can go east towards the Kitchen, south to the Staff Rooms or west to get to the Grand Hall.

You can see a burger here.

>interrogate shrek
Well, to be honest, I didn't really like tha" guy. Don't hold it against me, but he was a right rich snob, he was! Aye, I dinnae think he deserved to be killed, but och, he sure knew how t'make a person want t'kill him! Hah! What, did I say somethin" wrong?

>n
You can't go that way.

>interrogate shakira
Ah, cariño, I work in the same industry as Simon, and let me tell you, it's not uncommon to make enemies with some very powerful people. But Dios mío, I never expected this! We used to be close, working together a lot, but not so much lately. Simon and I even did a collab on a song once, back when he was still part of a group. Ay, perdón, I'm still in shock... ¡qué locura! Who in their right mind could have done such a horrible thing?

>interrogate smurfette
I would NEVER hurt anyone! I'm a SMURF for Smurf's sake! And on top of that, I'm Simon's SMURFriend! We've been dating for 2 smurftastic years, and he was an absolute gem! Oh-OH SIMON!!! starts crying How could anyone be so cruel? I bet it was Gargamel! That evil wizard must've put a spell on someone to do his SMURFY dirty work! sniffs dramatically

>interrogate mario
Oh mamma mia, che incubo! He was like-a my brother, you know... or-a at least... nevermind. I still can't-a believe what-a happened! Me and Simon, we got-a closer after-a his brothers died. He was lonely, needed a friend, so I-a stepped up, you know? It wasn't-a me! Oh povero Simon! I was-a just going to...no, why-a would I ever-a hurt him?!

>interrogate spongebob
Haha! Chipmunk?? What chipmunk? I have NEVER seen one in my life! OH SIMON THE CHIPMUNK! Of course I know Simon! He was always hanging around the Krusty Krab... you know, trying to sneak free Krabby Patties! Why do you ask?...... NO, I'M NOT HIDING ANYTHING!! YOU'LL NEVER CATCH ME ALIVE! runs away, slipping on some butter

>n
You can't go that way.

>n
You can't go that way.

* * *

>n
dining room
The dining room exudes grandeur, with a long, polished oak table set for a feast that never came. Ornate chairs, upholstered in rich velvet, are carefully arranged around it, though one seems hastily pushed back, as if someone stood up abruptly. Crystal chandeliers hang from the ceiling, their glow reflecting off fine china and silverware.

From here you can go east towards the Kitchen, south to the Staff Rooms or west to get to the Grand Hall.

You can see a burger here.

>interrogate smurfette
I would NEVER hurt anyone! I'm a SMURF for Smurf's sake! And on top of that, I'm Simon's SMURFriend! We've been dating for 2 smurftastic years, and he was an absolute gem! Oh-OH SIMON!!! starts crying How could anyone be so cruel? I bet it was Gargamel! That evil wizard must've put a spell on someone to do his SMURFY dirty work! sniffs dramatically

* * *

>n
dining room
The dining room exudes grandeur, with a long, polished oak table set for a feast that never came. Ornate chairs, upholstered in rich velvet, are carefully arranged around it, though one seems hastily pushed back, as if someone stood up abruptly. Crystal chandeliers hang from the ceiling, their glow reflecting off fine china and silverware.

From here you can go east towards the Kitchen, south to the Staff Rooms or west to get to the Grand Hall.

You can see a burger here.

>n
Simon's room
Simon's room feels more like a miniature world than a traditional bedroom. Tiny, ornate furniture is arranged with meticulous precision, from a walnut-shell bed lined with silk to a thimble-sized lamp on the nightstand. The air is sweet with the faint scent of acorns, and an open chest in the corner overflows with shiny trinkets and treasures. Despite its charm, a few scattered papers on the floor and a knocked-over stool suggest that not everything was as perfectly in place as it seemed.

From here you can only go south to the Small Hall.

You can see a bed, a mirror, a poster and a computer here.

>look under the bed
You find a photograph here.

>look under bed
You can't see any such thing.

* * *

>look under the bed
You find a photograph here.

>examine photo
A photograph of a chipmunk standing next to a female gnome eating a pizza. The writing on the back says, "From Rose to her little brother."

* * *

>look under bed
You find a photograph here.

>e
You can't go that way.

>take photo
You already have that.

>s
Small Hall
A narrow passageway connecting the rooms upstairs, the small hall is dimly lit, with worn rugs lining the floor. A faint scuff mark on the wall catches your attention, its origin unknown but undoubtedly suspicious.

From here you can go east to the Living Room, north to enter Simon's room or south down the stairs to the Grand Hall.

>e
Living room
This is the room where it happened. Though the police have removed the body, the faint metallic scent of blood still lingers in the air. The grand furniture and ornate decor now feel cold and uninviting, as if the room itself remembers the crime.

From here you can go north to the Library, west to the Small Hall or east to get to the Terrace.

You can see Duck-tective here.

>e
terrace
The terrace offers a breathtaking view of the garden below, though the cold night air seems to carry a sense of unease. Elegant wrought-iron furniture is neatly arranged, yet a single chair is overturned, hinting at a moment of panic or a hurried escape.

From here you can go west to the Living room.

You can see a vase of roses here.

>look under vase
You find a key hidden under the vase.

>take key
You already have that.

>look under vase
You find nothing of interest.

* * *

>look behind mirror
Behind the mirror, you notice a deep hole in the wall. It's not big enough to walk into but you can crawl north inside the hole.

>n
Darkness
It is pitch dark, and you can't see a thing.

>s
Simon's room
Simon's room feels more like a miniature world than a traditional bedroom. Tiny, ornate furniture is arranged with meticulous precision, from a walnut-shell bed lined with silk to a thimble-sized lamp on the nightstand. The air is sweet with the faint scent of acorns, and an open chest in the corner overflows with shiny trinkets and treasures. Despite its charm, a few scattered papers on the floor and a knocked-over stool suggest that not everything was as perfectly in place as it seemed.

From here you can only go south to the Small Hall.

You can see a bed and a mirror here.

>s
Small Hall
A narrow passageway connecting the rooms upstairs, the small hall is dimly lit, with worn rugs lining the floor. A faint scuff mark on the wall catches your attention, its origin unknown but undoubtedly suspicious.

From here you can go east to the Living Room, north to enter Simon's room or south down the stairs to the Grand Hall.

>s
Grand Hall
The centerpiece of the mansion, the grand hall exudes luxury with its gleaming marble floor and an opulent chandelier that sparkles above. Yet, the wide staircase and empty corridors seem to echo with whispers, as if the room itself is watching.

From here you can go west out the back door to the Garden, south towards the Main Entrance, east to the Dining Room or north up stairs towards the Small Hall.

You can see a map, a wooden bat, a flashlight and a suit of armor here.

>take flashlight
Taken.

>n
Small Hall
A narrow passageway connecting the rooms upstairs, the small hall is dimly lit, with worn rugs lining the floor. A faint scuff mark on the wall catches your attention, its origin unknown but undoubtedly suspicious.

From here you can go east to the Living Room, north to enter Simon's room or south down the stairs to the Grand Hall.

>n
Simon's room
Simon's room feels more like a miniature world than a traditional bedroom. Tiny, ornate furniture is arranged with meticulous precision, from a walnut-shell bed lined with silk to a thimble-sized lamp on the nightstand. The air is sweet with the faint scent of acorns, and an open chest in the corner overflows with shiny trinkets and treasures. Despite its charm, a few scattered papers on the floor and a knocked-over stool suggest that not everything was as perfectly in place as it seemed.

From here you can only go south to the Small Hall.

You can see a bed and a mirror here.

>n
hole
It's a hidden tunnel! And look-there, at the end, a chest awaits! No amount of money or fame could ever change the fact that he was just a small chipmunk.

You can see a hidden chest here.

>examine chest
A locked chest is tucked away inside the hole. Who knows what treasures lie inside...

>open chest
It seems to be locked.

* * *

>look at computer
The computer is locked. You'll need to type the correct password to unlock it.

>examine computer
The computer is locked. You'll need to type the correct password to unlock it.

* * *

>examine computer
The computer is locked. You'll need to type the correct password to unlock it. To guess the password write "type (password).

>type alvin
The computer accepts the password and unlocks with a soft beep. The desktop is now accessible.

>examine computer
The computer is unlocked and displays its desktop. A messaging app icon catches your eye. You open it to see a chat with Simon's manager. 
"Simon: Did you get the files for the next song?" 
"Manager: Yes, it's the chart-topper from that artist we talked about. I'll tweak it to make it unrecognizable." 
"Simon: Perfect. Once I rework the lyrics, it'll be another hit for me." 
"Manager: Don't forget my cut for \other services.\" 
"Simon: Relax. Your payment is already scheduled."

* * *

>n
dining room
The dining room exudes grandeur, with a long, polished oak table set for a feast that never came. Ornate chairs, upholstered in rich velvet, are carefully arranged around it, though one seems hastily pushed back, as if someone stood up abruptly. Crystal chandeliers hang from the ceiling, their glow reflecting off fine china and silverware.

From here you can go east towards the Kitchen, south to the Staff Rooms or west to get to the Grand Hall.

You can see a burger here.

>e
Kitchen
The kitchen, warm and bustling earlier, now feels oddly sterile. Pots and pans hang from hooks above the counters, and the faint aroma of spices lingers. However, something tells you this kitchen holds secrets beyond its recipes.

From here you can go west to the Dining Room.

You can see a sticky note here.

>e
terrace
The terrace offers a breathtaking view of the garden below, though the cold night air seems to carry a sense of unease. Elegant wrought-iron furniture is neatly arranged, yet a single chair is overturned, hinting at a moment of panic or a hurried escape.

From here you can go west to the Living room.

You can see a vase of roses here.

* * *

>take key
You already have that.

>examine map
You can't see any such thing.

>w
Living room
This is the room where it happened. Though the police have removed the body, the faint metallic scent of blood still lingers in the air. The grand furniture and ornate decor now feel cold and uninviting, as if the room itself remembers the crime.

From here you can go north to the Library, west to the Small Hall or east to get to the Terrace.

You can see Duck-tective here.

>w
Small Hall
A narrow passageway connecting the rooms upstairs, the small hall is dimly lit, with worn rugs lining the floor. A faint scuff mark on the wall catches your attention, its origin unknown but undoubtedly suspicious.

From here you can go east to the Living Room, north to enter Simon's room or south down the stairs to the Grand Hall.

>s
Grand Hall
The centerpiece of the mansion, the grand hall exudes luxury with its gleaming marble floor and an opulent chandelier that sparkles above. Yet, the wide staircase and empty corridors seem to echo with whispers, as if the room itself is watching.

From here you can go west out the back door to the Garden, south towards the Main Entrance, east to the Dining Room or north up stairs towards the Small Hall.

You can see a map here.

>w
Garden
The garden is pristine, every bush and flower meticulously arranged to perfection, as if prepared for a royal visit. Strings of fairy lights drape from tree to tree, casting a soft, golden glow over the vibrant blooms. The scent of roses and freshly mowed grass lingers in the crisp night air. A majestic fountain sparkles at the center, but nearby, a once-proud marble sculpture lies shattered on the ground, its pieces scattered like a puzzle. The damage looks fresh, and the footprints leading away suggest someone was here-and left in a hurry.

From here you can go east to go to the Grand Hall.

You can see a rose chest (closed) and a rose bush here.

>open chest
It seems to be locked.

* * *

>e
terrace
The terrace offers a breathtaking view of the garden below, though the cold night air seems to carry a sense of unease. Elegant wrought-iron furniture is neatly arranged, yet a single chair is overturned, hinting at a moment of panic or a hurried escape.

From here you can go west to the Living room.

You can see a vase of roses here.

>look under the vase
You find a key hidden under the vase.

>take key
You already have that.

>w
Living room
This is the room where it happened. Though the police have removed the body, the faint metallic scent of blood still lingers in the air. The grand furniture and ornate decor now feel cold and uninviting, as if the room itself remembers the crime.

From here you can go north to the Library, west to the Small Hall or east to get to the Terrace.

The fireplace is cold and filled with a layer of ash, the charred remains of logs scattered within. Something faintly catches the eye-barely noticeable amid the soot, as if hiding in plain sight.

You can also see Duck-tective and a mushroom here.

>w
Small Hall
A narrow passageway connecting the rooms upstairs, the small hall is dimly lit, with worn rugs lining the floor. A faint scuff mark on the wall catches your attention, its origin unknown but undoubtedly suspicious.

From here you can go east to the Living Room, north to enter Simon's room or south down the stairs to the Grand Hall.

>s
Grand Hall
The centerpiece of the mansion, the grand hall exudes luxury with its gleaming marble floor and an opulent chandelier that sparkles above. Yet, the wide staircase and empty corridors seem to echo with whispers, as if the room itself is watching.

From here you can go west out the back door to the Garden, south towards the Main Entrance, east to the Dining Room or north up stairs towards the Small Hall.

You can see a map, a wooden bat, a flashlight and a suit of armor here.

>w
Darkness
It is pitch dark, and you can't see a thing.

>e
Grand Hall
The centerpiece of the mansion, the grand hall exudes luxury with its gleaming marble floor and an opulent chandelier that sparkles above. Yet, the wide staircase and empty corridors seem to echo with whispers, as if the room itself is watching.

From here you can go west out the back door to the Garden, south towards the Main Entrance, east to the Dining Room or north up stairs towards the Small Hall.

You can see a map, a wooden bat, a flashlight and a suit of armor here.

>take flashlight
Taken.

>w
Garden
The garden is pristine, every bush and flower meticulously arranged to perfection, as if prepared for a royal visit. The scent of roses and freshly mowed grass lingers in the crisp night air. A majestic fountain sparkles at the center, but nearby, a once-proud marble sculpture lies shattered on the ground, its pieces scattered like a puzzle. The damage looks fresh, and the footprints leading away suggest someone was here-and left in a hurry. From here you can go east to go to the Grand Hall.

From here you can go east to go to the Grand Hall.

You can see a rose bush and a statue here.

>look inside the bush
You find nothing of interest.

>look behind bush
There's a small chest there.

>open chest
With a creak, the chest opens, revealing a vast amount of gold and money spilling out! Piles of coins, jewels, and stacks of bills fill the chest. Whoever knew about this chest, had a strong motive for murdering poor Simon. How did you find that key again?

* * *

>e
Kitchen
The kitchen, warm and bustling earlier, now feels oddly sterile. Pots and pans hang from hooks above the counters, and the faint aroma of spices lingers. However, something tells you this kitchen holds secrets beyond its recipes.

From here you can go west to the Dining Room.

You can see a sticky note here.

>n
library
A sanctuary of knowledge turned suspicious. The heavy scent of old books and polished wood fills the air, while rows of towering shelves cast long shadows. A grand desk sits in the corner, its surface cluttered with papers that seem oddly out of place, as if someone had been searching for something. Most of the books are dusty, it's obvious they haven't been touched for years. But a couple of them were obviously recently taken from the dusty shelves.

From here you can go south to the Living Room.

You can see a family history book and a document here.

>examine document
The table is a mess of scattered papers, some crumpled, others smudged with dirt. Pages overlap at odd angles, diagrams half-hidden beneath budget sheets and handwritten notes. But one document stands out with something scribbled on it.

>read document
The table is a mess of scattered papers, some crumpled, others smudged with dirt. Pages overlap at odd angles, diagrams half-hidden beneath budget sheets and handwritten notes. But one document stands out with something scribbled on it.

* * *

>e
Kitchen
The kitchen, warm and bustling earlier, now feels oddly sterile. Pots and pans hang from hooks above the counters, and the faint aroma of spices lingers. However, something tells you this kitchen holds secrets beyond its recipes.

From here you can go west to the Dining Room.

You can see a sticky note here.

I beg your pardon?

>n
library
A sanctuary of knowledge turned suspicious. The heavy scent of old books and polished wood fills the air, while rows of towering shelves cast long shadows. A grand desk sits in the corner, its surface cluttered with papers that seem oddly out of place, as if someone had been searching for something. Most of the books are dusty, it's obvious they haven't been touched for years. But a couple of them were obviously recently taken from the dusty shelves.

From here you can go south to the Living Room.

You can see a family history book and a document here.

>read document
You read: Project Documentation - "The Swampwood Initiative"

Title Page: "The Swampwood Initiative: Sustainable Resources for the Future" Below the title, a logo of a sleek tree with its roots intertwined in dollar signs.

Key Excerpt (Page 3): Phase One: Harvesting the untapped potential of swamp ecosystems. The unique tree species found sorrounding swamps will provide unmatched durability and aesthetic for luxury furniture and construction materials.

Budget Overview (Page 7): Projected Annual Revenue: $3.5 million. Project funded by Simon Woodsworth (lead investor).

Environmental Impact Analysis (Page 12): "Minimal disruption" circled furiously, with "LIARS" scrawled next to it.

Handwritten Letter (Tucked into the papers): A note addressed to Simon: "Simon, I trust you'll handle the "green activists" in your area. We need those trees cleared by next quarter. No delays." It's signed with the initials "G.B."

* * *

>read note
You read: The note says Keep quiet. If you know what's good for you, stay out of it. You don't want to see what happens if you don't. A greasy stain at the bottom of the note-strangely, it smells faintly of seawater.

* * *

>w
dining room
The dining room exudes grandeur, with a long, polished oak table set for a feast that never came. Ornate chairs, upholstered in rich velvet, are carefully arranged around it, though one seems hastily pushed back, as if someone stood up abruptly. Crystal chandeliers hang from the ceiling, their glow reflecting off fine china and silverware.

From here you can go east towards the Kitchen, south to the Staff Rooms or west to get to the Grand Hall.

You can see a burger here.

* * *

>n
dining room
The dining room exudes grandeur, with a long, polished oak table set for a feast that never came. Ornate chairs, upholstered in rich velvet, are carefully arranged around it, though one seems hastily pushed back, as if someone stood up abruptly. Crystal chandeliers hang from the ceiling, their glow reflecting off fine china and silverware.

From here you can go east towards the Kitchen, south to the Staff Rooms or west to get to the Grand Hall.

You can see a burger here.

I beg your pardon?

>n
Simon's room
Simon's room feels more like a miniature world than a traditional bedroom. Tiny, ornate furniture is arranged with meticulous precision, from a walnut-shell bed lined with silk to a thimble-sized lamp on the nightstand. The air is sweet with the faint scent of acorns, and an open chest in the corner overflows with shiny trinkets and treasures. Despite its charm, a few scattered papers on the floor and a knocked-over stool suggest that not everything was as perfectly in place as it seemed.

From here you can only go south to the Small Hall.

You can see a bed, a mirror, a poster and a computer here.

>look at computer
The computer is locked. You'll need to type the correct password to unlock it. To guess the password write "type (password).

>type Alvin
The computer flashes an error message: "Invalid Password. Try Again."

* * *

>n
dining room
The dining room exudes grandeur, with a long, polished oak table set for a feast that never came. Ornate chairs, upholstered in rich velvet, are carefully arranged around it, though one seems hastily pushed back, as if someone stood up abruptly. Crystal chandeliers hang from the ceiling, their glow reflecting off fine china and silverware.

From here you can go east towards the Kitchen, south to the Staff Rooms or west to get to the Grand Hall.

You can see a burger here.

>examine burger
Someone took only one bite of this Krabby Patty. I wonder if it was poisoned or simply bad.

* * *

>read burger
Nothing is written on the burger.

>w
Grand Hall
The centerpiece of the mansion, the grand hall exudes luxury with its gleaming marble floor and an opulent chandelier that sparkles above. Yet, the wide staircase and empty corridors seem to echo with whispers, as if the room itself is watching.

From here you can go west out the back door to the Garden, south towards the Main Entrance, east to the Dining Room or north up stairs towards the Small Hall.

You can see a map, a wooden bat, a flashlight and a suit of armor here.

>examine map
N
                                                 
                                Simon's room        Library
                                            |                        |
                                            |                        |
                                     Small Hall ------ Living Room ---- Terrace
 W                                        |                                                                        E 
                                            |                         
                  Garden ----Grand Hall --- Dining Room ------ Kitchen
                                            |                       |
                                            |                       |
                               Main Entrance     Staff Room
                                          
                                                         S

* * *

>examine burger
Someone took only one bite of this Krabby Patty. I wonder if it was poisoned or simply bad.

>s
Staff Room
A small, functional room where the staff can catch their breath. The furniture is sparse-just a couple of old chairs and a cluttered table with papers scattered across it. The air feels thick with unease as all the suspects have been brought here until the investigation is over. They sit in silence, each one lost in their thoughts, glancing nervously at each other. After you gather up the initial information, you can ask them about the clues you find to get information about it.

Go ahead and interrogate the suspects!

From here you can go north to the Dining Room.

You can see Shrek the ogre, Super Mario, SpongeBob, Smurfette and Shakira here.

>examine spongebob
SpongeBob is, as always, full of energy, but there's a strange heaviness to his usual wide-eyed optimism tonight. His square, yellow sponge body and big blue eyes are instantly recognizable. His youthful grin masks a deeper tension beneath the surface. His movements are a little twitchy, and he seems to be avoiding certain suspects in the room, though you can't quite tell why.

>interrogate spongebob
SpongeBob: Haha! Chipmunk?? What chipmunk? I have NEVER seen one in my life! OH SIMON THE CHIPMUNK! Of course I know Simon! He was always hanging around the Krusty Krab... He even employed me to make Krabby Patties for some parties he was hosting. Why do you ask?...... NO, I'M NOT HIDING ANYTHING!! YOU'LL NEVER CATCH ME ALIVE! He runs away, slipping on some butter.

>interrogate spongebob
You begin questioning SpongeBob.
SpongeBob: Ah, so you've tried the old Krabby Patty! Glad to have a new costumer! Sorry, I can't tell you the recipe. It's a secret.

>interrogate spongebob
You begin questioning SpongeBob.
SpongeBob: Ah, so you've tried the old Krabby Patty! Glad to have a new costumer! Sorry, I can't tell you the recipe. It's a secret.

>interrogate shakira
Shakira: Ah, cariño, I work in the same industry as Simon, and let me tell you, it's not uncommon to make enemies with some very powerful people. But Dios mío, I never expected this! We used to be close, working together a lot, but not so much lately. Simon and I even did a collab on a song once, back when he was still part of a group. Ay, perdón, I'm still in shock... ¡qué locura! Who in their right mind could have done such a horrible thing?

>interrogate shakira
You begin questioning Shakira.
Shakira says, "I already told you, I have nothing to do with this!"

* * *

>examine maš
You can't see any such thing.

>examine map
N
                                                 
                                Simon's room        Library
                                            |                        |
                                            |                        |
                                     Small Hall ------ Living Room ---- Terrace
 W                                        |                                                                        E 
                                            |                         
                  Garden ----Grand Hall --- Dining Room ------ Kitchen
                                            |                       |
                                            |                       |
                               Main Entrance     Staff Room
                                          
                                                         S

* * *

>map
That's not a verb I recognise.

>look at map
N
                                                 
                                Simon's room        Library
                                            |                        |
                                            |                        |
                                     Small Hall ------ Living Room ---- Terrace
 W                                        |                                                                        E 
                                            |                         
                  Garden ----Grand Hall --- Dining Room ------ Kitchen
                                            |                       |
                                            |                       |
                               Main Entrance     Staff Room
                                          
                                                         S

* * *

>n
Small Hall
A narrow passageway connecting the rooms upstairs, the small hall is dimly lit, with worn rugs lining the floor. A faint scuff mark on the wall catches your attention, its origin unknown but undoubtedly suspicious.

From here you can go east to the Living Room, north to enter Simon's room or south down the stairs to the Grand Hall.

>n
Simon's room
Simon's room feels more like a miniature world than a traditional bedroom. Tiny, ornate furniture is arranged with meticulous precision, from a walnut-shell bed lined with silk to a thimble-sized lamp on the nightstand. The air is sweet with the faint scent of acorns, and an open chest in the corner overflows with shiny trinkets and treasures. Despite its charm, a few scattered papers on the floor and a knocked-over stool suggest that not everything was as perfectly in place as it seemed.

From here you can only go south to the Small Hall.

You can see a photo here.

* * *

>w
Darkness
It is pitch dark, and you can't see a thing.

>look behind the bush
There's a small chest there.

>examine chest
A beautifully crafted chest with rose carvings on it. It's locked tight.

* * *

>w
Darkness
It is pitch dark, and you can't see a thing.

>e
Grand Hall
The centerpiece of the mansion, the grand hall exudes luxury with its gleaming marble floor and an opulent chandelier that sparkles above. Yet, the wide staircase and empty corridors seem to echo with whispers, as if the room itself is watching.

From here you can go west out the back door to the Garden, south towards the Main Entrance, east to the Dining Room or north up stairs towards the Small Hall.

A flashlight might come in handy for dark spaces.

You can also see a map and a wooden bat here.

>take flashlight
Taken.

* * *

>take flashlight
Taken.

* * *

>look behind bush
There's a small chest there.

>open chest
It seems to be locked.

>e
Grand Hall
The centerpiece of the mansion, the grand hall exudes luxury with its gleaming marble floor and an opulent chandelier that sparkles above. Yet, the wide staircase and empty corridors seem to echo with whispers, as if the room itself is watching.

From here you can go west out the back door to the Garden, south towards the Main Entrance, east to the Dining Room or north up stairs towards the Small Hall.

You can see a map, a wooden bat and a suit of armor here.

>n
Small Hall
A narrow passageway connecting the rooms upstairs, the small hall is dimly lit, with worn rugs lining the floor. A faint scuff mark on the wall catches your attention, its origin unknown but undoubtedly suspicious.

From here you can go east to the Living Room, north to enter Simon's room or south down the stairs to the Grand Hall.

* * *

>n
Simon's room
Simon's room feels more like a miniature world than a traditional bedroom. Tiny, ornate furniture is arranged with meticulous precision, from a walnut-shell bed lined with silk to a thimble-sized lamp on the nightstand. The air is sweet with the faint scent of acorns, and an open chest in the corner overflows with shiny trinkets and treasures. Despite its charm, a few scattered papers on the floor and a knocked-over stool suggest that not everything was as perfectly in place as it seemed.

From here you can only go south to the Small Hall.

You can see a bed and a mirror here.

>s
Small Hall
A narrow passageway connecting the rooms upstairs, the small hall is dimly lit, with worn rugs lining the floor. A faint scuff mark on the wall catches your attention, its origin unknown but undoubtedly suspicious.

From here you can go east to the Living Room, north to enter Simon's room or south down the stairs to the Grand Hall.

>w
You can't go that way.

>e
Living room
This is the room where it happened. Though the police have removed the body, the faint metallic scent of blood still lingers in the air. The grand furniture and ornate decor now feel cold and uninviting, as if the room itself remembers the crime.

From here you can go north to the Library, west to the Small Hall or east to get to the Terrace.

The fireplace is cold and filled with a layer of ash, the charred remains of logs scattered within. Something faintly catches the eye-barely noticeable amid the soot, as if hiding in plain sight.

You can also see Duck-tective and a mushroom here.

>e
terrace
The terrace offers a breathtaking view of the garden below, though the cold night air seems to carry a sense of unease. Elegant wrought-iron furniture is neatly arranged, yet a single chair is overturned, hinting at a moment of panic or a hurried escape.

From here you can go west to the Living room.

You can see a vase of roses here.

* * *

>look under vase
You find a key hidden under the vase.

>w
Living room
This is the room where it happened. Though the police have removed the body, the faint metallic scent of blood still lingers in the air. The grand furniture and ornate decor now feel cold and uninviting, as if the room itself remembers the crime.

From here you can go north to the Library, west to the Small Hall or east to get to the Terrace.

The fireplace is cold and filled with a layer of ash, the charred remains of logs scattered within. Something faintly catches the eye-barely noticeable amid the soot, as if hiding in plain sight.

You can also see Duck-tective and a mushroom here.

* * *

>w
Small Hall
A narrow passageway connecting the rooms upstairs, the small hall is dimly lit, with worn rugs lining the floor. A faint scuff mark on the wall catches your attention, its origin unknown but undoubtedly suspicious.

From here you can go east to the Living Room, north to enter Simon's room or south down the stairs to the Grand Hall.

>s
Grand Hall
The centerpiece of the mansion, the grand hall exudes luxury with its gleaming marble floor and an opulent chandelier that sparkles above. Yet, the wide staircase and empty corridors seem to echo with whispers, as if the room itself is watching.

From here you can go west out the back door to the Garden, south towards the Main Entrance, east to the Dining Room or north up stairs towards the Small Hall.

You can see a map, a wooden bat and a suit of armor here.

>w
Garden
The garden is pristine, every bush and flower meticulously arranged to perfection, as if prepared for a royal visit. The scent of roses and freshly mowed grass lingers in the crisp night air. A majestic fountain sparkles at the center, but nearby, a once-proud marble sculpture lies shattered on the ground, its pieces scattered like a puzzle. The damage looks fresh, and the footprints leading away suggest someone was here-and left in a hurry. From here you can go east to go to the Grand Hall.

From here you can go east to go to the Grand Hall.

You can see a rose chest, a rose bush and a statue here.

>look behind bush
Nothing special there.

* * *

>n
Simon's room
Simon's room feels more like a miniature world than a traditional bedroom. Tiny, ornate furniture is arranged with meticulous precision, from a walnut-shell bed lined with silk to a thimble-sized lamp on the nightstand. The air is sweet with the faint scent of acorns, and an open chest in the corner overflows with shiny trinkets and treasures. Despite its charm, a few scattered papers on the floor and a knocked-over stool suggest that not everything was as perfectly in place as it seemed.

From here you can only go south to the Small Hall.

You can see a bed and a mirror here.

>look behind mirror
Behind the mirror, you notice a deep hole in the wall. It's not big enough to walk into but you can crawl north inside the hole.

>n
You can't go that way.

* * *

>n
Small Hall
A narrow passageway connecting the rooms upstairs, the small hall is dimly lit, with worn rugs lining the floor. A faint scuff mark on the wall catches your attention, its origin unknown but undoubtedly suspicious.

From here you can go east to the Living Room, north to enter Simon's room or south down the stairs to the Grand Hall.

>e
Living room
This is the room where it happened. Though the police have removed the body, the faint metallic scent of blood still lingers in the air. The grand furniture and ornate decor now feel cold and uninviting, as if the room itself remembers the crime.

From here you can go north to the Library, west to the Small Hall or east to get to the Terrace.

The fireplace is cold and filled with a layer of ash, the charred remains of logs scattered within. Something faintly catches the eye-barely noticeable amid the soot, as if hiding in plain sight.

You can also see Duck-tective and a mushroom here.

* * *

>look under vase
You find a key hidden under the vase.

>e
You can't go that way.

>w
Living room
This is the room where it happened. Though the police have removed the body, the faint metallic scent of blood still lingers in the air. The grand furniture and ornate decor now feel cold and uninviting, as if the room itself remembers the crime.

From here you can go north to the Library, west to the Small Hall or east to get to the Terrace.

The fireplace is cold and filled with a layer of ash, the charred remains of logs scattered within. Something faintly catches the eye-barely noticeable amid the soot, as if hiding in plain sight.

You can also see Duck-tective and a mushroom here.

* * *

>s
Grand Hall
The centerpiece of the mansion, the grand hall exudes luxury with its gleaming marble floor and an opulent chandelier that sparkles above. Yet, the wide staircase and empty corridors seem to echo with whispers, as if the room itself is watching.

From here you can go west out the back door to the Garden, south towards the Main Entrance, east to the Dining Room or north up stairs towards the Small Hall.

You can see a map, a wooden bat and a suit of armor here.

>w
Garden
The garden is pristine, every bush and flower meticulously arranged to perfection, as if prepared for a royal visit. The scent of roses and freshly mowed grass lingers in the crisp night air. A majestic fountain sparkles at the center, but nearby, a once-proud marble sculpture lies shattered on the ground, its pieces scattered like a puzzle. The damage looks fresh, and the footprints leading away suggest someone was here-and left in a hurry. From here you can go east to go to the Grand Hall.

From here you can go east to go to the Grand Hall.

You can see a rose bush and a statue here.

* * *

>look behind bush
There's a small chest there.

>examine statue
Amidst the flowers, a Greek statue lies shattered on the ground. The head rests a few feet away, the arms broken and scattered. Cracks spider through the marble, leaving it a shadow of its former grandeur.

>look behind bush
There's a small chest there.

* * *

>open chest
It seems to be locked.

>unlock chest
What do you want to unlock the rose chest with?

>unlock chest with key
You turn the rose key in the lock, and with a satisfying click, the chest opens. Inside, you find a letter from Simon's dad.

>read letter
Is it a love letter? Is it a suicide note? Only way to find out is to read it!

* * *

>examine suit
A tall, imposing suit of armor stands here, its polished surface reflecting the dim light.

* * *

>e
dining room
The dining room exudes grandeur, with a long, polished oak table set for a feast that never came. Ornate chairs, upholstered in rich velvet, are carefully arranged around it, though one seems hastily pushed back, as if someone stood up abruptly. Crystal chandeliers hang from the ceiling, their glow reflecting off fine china and silverware.

From here you can go east towards the Kitchen, south to the Staff Rooms or west to get to the Grand Hall.

You can see a burger here.

>s
Staff Room
A small, functional room where the staff can catch their breath. The furniture is sparse-just a couple of old chairs and a cluttered table with papers scattered across it. The air feels thick with unease as all the suspects have been brought here until the investigation is over. They sit in silence, each one lost in their thoughts, glancing nervously at each other. After you gather up the initial information, you can ask them about the clues you find to get information about it.

Go ahead and interrogate the suspects!

From here you can go north to the Dining Room.

You can see Shrek the ogre, Super Mario, SpongeBob, Smurfette and Shakira here.

>interrogate shrek
Shrek: Well, to be honest, I didn't really like tha" guy. Don't hold it against me, but he was a right rich snob, he was! Aye, I dinnae think he deserved to be killed, but och, he sure knew how t'make a person want t'kill him! Hah! What, did I say somethin" wrong?

>n
dining room
The dining room exudes grandeur, with a long, polished oak table set for a feast that never came. Ornate chairs, upholstered in rich velvet, are carefully arranged around it, though one seems hastily pushed back, as if someone stood up abruptly. Crystal chandeliers hang from the ceiling, their glow reflecting off fine china and silverware.

From here you can go east towards the Kitchen, south to the Staff Rooms or west to get to the Grand Hall.

You can see a burger here.

* * *

>s
Staff Room
A small, functional room where the staff can catch their breath. The furniture is sparse-just a couple of old chairs and a cluttered table with papers scattered across it. The air feels thick with unease as all the suspects have been brought here until the investigation is over. They sit in silence, each one lost in their thoughts, glancing nervously at each other. After you gather up the initial information, you can ask them about the clues you find to get information about it.

Go ahead and interrogate the suspects!

From here you can go north to the Dining Room.

You can see Shrek the ogre, Super Mario, SpongeBob, Smurfette and Shakira here.

>interrogate spongebob
SpongeBob: Haha! Chipmunk?? What chipmunk? I have NEVER seen one in my life! OH SIMON THE CHIPMUNK! Of course I know Simon! He was always hanging around the Krusty Krab... He even employed me to make Krabby Patties for some parties he was hosting. Why do you ask?...... NO, I'M NOT HIDING ANYTHING!! YOU'LL NEVER CATCH ME ALIVE! He runs away, slipping on some butter.

* * *

>interrogate spongebob
You begin questioning SpongeBob.
SpongeBob: Ah, so you've tried the old Krabby Patty! Glad to have a new costumer! Sorry, I can't tell you the recipe. It's a secret.

>interrogate shrek
You begin questioning Shrek the ogre.
Shrek the ogre says, "I already told you, I have nothing to do with this!"

>n
dining room
The dining room exudes grandeur, with a long, polished oak table set for a feast that never came. Ornate chairs, upholstered in rich velvet, are carefully arranged around it, though one seems hastily pushed back, as if someone stood up abruptly. Crystal chandeliers hang from the ceiling, their glow reflecting off fine china and silverware.

From here you can go east towards the Kitchen, south to the Staff Rooms or west to get to the Grand Hall.

You can see a burger here.

>e
Kitchen
The kitchen, warm and bustling earlier, now feels oddly sterile. Pots and pans hang from hooks above the counters, and the faint aroma of spices lingers. However, something tells you this kitchen holds secrets beyond its recipes.

From here you can go west to the Dining Room.

You can see a note here.

* * *

>examine note
A small sticky note left on the kitchen counter. There is something written on it.

* * *

>e
dining room
The dining room exudes grandeur, with a long, polished oak table set for a feast that never came. Ornate chairs, upholstered in rich velvet, are carefully arranged around it, though one seems hastily pushed back, as if someone stood up abruptly. Crystal chandeliers hang from the ceiling, their glow reflecting off fine china and silverware.

From here you can go east towards the Kitchen, south to the Staff Rooms or west to get to the Grand Hall.

You can see a burger here.

>e
Kitchen
The kitchen, warm and bustling earlier, now feels oddly sterile. Pots and pans hang from hooks above the counters, and the faint aroma of spices lingers. However, something tells you this kitchen holds secrets beyond its recipes.

From here you can go west to the Dining Room.

You can see a note here.

>read note
You read: The note says Keep quiet. If you know what's good for you, stay out of it. You don't want to see what happens if you don't. A greasy stain at the bottom of the note-strangely, it smells faintly of seawater.

>w
dining room
The dining room exudes grandeur, with a long, polished oak table set for a feast that never came. Ornate chairs, upholstered in rich velvet, are carefully arranged around it, though one seems hastily pushed back, as if someone stood up abruptly. Crystal chandeliers hang from the ceiling, their glow reflecting off fine china and silverware.

From here you can go east towards the Kitchen, south to the Staff Rooms or west to get to the Grand Hall.

You can see a burger here.

>s
Staff Room
A small, functional room where the staff can catch their breath. The furniture is sparse-just a couple of old chairs and a cluttered table with papers scattered across it. The air feels thick with unease as all the suspects have been brought here until the investigation is over. They sit in silence, each one lost in their thoughts, glancing nervously at each other. After you gather up the initial information, you can ask them about the clues you find to get information about it.

Go ahead and interrogate the suspects!

From here you can go north to the Dining Room.

You can see Shrek the ogre, Super Mario, SpongeBob, Smurfette and Shakira here.

* * *

>interrogate spongebob
SpongeBob: Haha! Chipmunk?? What chipmunk? I have NEVER seen one in my life! OH SIMON THE CHIPMUNK! Of course I know Simon! He was always hanging around the Krusty Krab... He even employed me to make Krabby Patties for some parties he was hosting. Why do you ask?...... NO, I'M NOT HIDING ANYTHING!! YOU'LL NEVER CATCH ME ALIVE! He runs away, slipping on some butter.

>interrogate spongebob
You begin questioning SpongeBob.
SpongeBob says, "I already told you, I have nothing to do with this!"

>n
dining room
The dining room exudes grandeur, with a long, polished oak table set for a feast that never came. Ornate chairs, upholstered in rich velvet, are carefully arranged around it, though one seems hastily pushed back, as if someone stood up abruptly. Crystal chandeliers hang from the ceiling, their glow reflecting off fine china and silverware.

From here you can go east towards the Kitchen, south to the Staff Rooms or west to get to the Grand Hall.

You can see a burger here.

>s
Staff Room
A small, functional room where the staff can catch their breath. The furniture is sparse-just a couple of old chairs and a cluttered table with papers scattered across it. The air feels thick with unease as all the suspects have been brought here until the investigation is over. They sit in silence, each one lost in their thoughts, glancing nervously at each other. After you gather up the initial information, you can ask them about the clues you find to get information about it.

Go ahead and interrogate the suspects!

From here you can go north to the Dining Room.

You can see Shrek the ogre, Super Mario, SpongeBob, Smurfette and Shakira here.

>interrogate spongebob
You begin questioning SpongeBob.
SpongeBob says, "I already told you, I have nothing to do with this!"

* * *

>interrogate spongebob
SpongeBob: Haha! Chipmunk?? What chipmunk? I have NEVER seen one in my life! OH SIMON THE CHIPMUNK! Of course I know Simon! He was always hanging around the Krusty Krab... He even employed me to make Krabby Patties for some parties he was hosting. Why do you ask?...... NO, I'M NOT HIDING ANYTHING!! YOU'LL NEVER CATCH ME ALIVE! He runs away, slipping on some butter.

>n
dining room
The dining room exudes grandeur, with a long, polished oak table set for a feast that never came. Ornate chairs, upholstered in rich velvet, are carefully arranged around it, though one seems hastily pushed back, as if someone stood up abruptly. Crystal chandeliers hang from the ceiling, their glow reflecting off fine china and silverware.

From here you can go east towards the Kitchen, south to the Staff Rooms or west to get to the Grand Hall.

You can see a burger here.

* * *

>e
Kitchen
The kitchen, warm and bustling earlier, now feels oddly sterile. Pots and pans hang from hooks above the counters, and the faint aroma of spices lingers. However, something tells you this kitchen holds secrets beyond its recipes.

From here you can go west to the Dining Room.

You can see a note here.

>examine note
A small sticky note left on the kitchen counter. There is something written on it.

>read note
You read: The note says Keep quiet. If you know what's good for you, stay out of it. You don't want to see what happens if you don't. A greasy stain at the bottom of the note-strangely, it smells faintly of seawater.

* * *

>[enter]
A Nutter Mystery
An Interactive Fiction by Laura Kriskovic
Release 1 / Serial number 250116 / Inform 7 build 6M62 (I6/v6.33 lib 6/12N) SD

Staff Room
A small, functional room where the staff can catch their breath. The furniture is sparse-just a couple of old chairs and a cluttered table with papers scattered across it. The air feels thick with unease as all the suspects have been brought here until the investigation is over. They sit in silence, each one lost in their thoughts, glancing nervously at each other. After you gather up the initial information, you can ask them about the clues you find to get information about it.

Go ahead and interrogate the suspects!

From here you can go north to the Dining Room.

You can see Shrek the ogre, Super Mario, SpongeBob, Smurfette and Shakira here.

>guess Shrek
You accuse Shrek, and Duck-tective rolls his eyes.

"Shrek found out Mario was behind a project destroying his beloved swamp, so he set off to avenge his home. Armed with a wooden bat, he arrived at Simon's house, ready to wreak havoc. He started by smashing a statue in the garden when Simon opened the door. Realizing the trouble he was in, Simon invited Shrek to the party, trying to calm him down. Shrek, though furious, eased up a little after a few Krabby Patties."

"But things took a turn when Shrek snooped around Simon's house and found a document confirming the project was already set in motion, claiming minimal environmental impact. Enraged by the deceit, Shrek couldn't hold back. At the party, in front of everyone, he stomped down hard on Simon, crushing him completely. No one even noticed as his tiny body was crushed underfoot." "Shrek just stood there, panting. His face twisted in frustration. "I couldn't let him get away with it. He was ruin" everything... ma family... ma swamp," Shrek muttered to himself, rubbin" his brow. "But now... now it's safe. Too bad it had to end like this."

Duck-tective lets out a long sigh. "A sad way for things to end…but that is the tragic way of life."
That's not a verb I recognise.

* * *

>guess shrek
You accuse Shrek, and Duck-tective rolls his eyes.

"Shrek found out Mario was behind a project destroying his beloved swamp, so he set off to avenge his home. Armed with a wooden bat, he arrived at Simon's house, ready to wreak havoc. He started by smashing a statue in the garden when Simon opened the door. Realizing the trouble he was in, Simon invited Shrek to the party, trying to calm him down. Shrek, though furious, eased up a little after a few Krabby Patties."

"But things took a turn when Shrek snooped around Simon's house and found a document confirming the project was already set in motion, claiming minimal environmental impact. Enraged by the deceit, Shrek couldn't hold back. At the party, in front of everyone, he stomped down hard on Simon, crushing him completely. No one even noticed as his tiny body was crushed underfoot." "Shrek just stood there, panting. His face twisted in frustration. "I couldn't let him get away with it. He was ruin" everything... ma family... ma swamp," Shrek muttered to himself, rubbin" his brow. "But now... now it's safe. Too bad it had to end like this."

Duck-tective lets out a long sigh. "A sad way for things to end…but that is the tragic way of life."

    *** The End ***

Would you like to RESTART, RESTORE a saved game, QUIT or UNDO the last command?

I beg your pardon?

* * *

>guess shakira
You accuse Shakira, and her face remains calm, though her eyes betray something else. Duck-tective steps forward, his beak sharp as he recounts the story.

"Shakira met Simon years ago when he was just a young chipmunk. She saw his potential and watched as he skyrocketed to fame with his boy band, "Alvin and the Chipmunks." She even worked with him on a song once, proud of how far he had come. But that pride quickly turned to anger. Shakira soon discovered that Simon had been stealing songs from artists, including her. He'd change them just enough to avoid lawsuits, then claim them as his own. That was enough to make Shakira see red."

"On New Year's Eve, Simon invited her to perform, promising her payment for her time. But that wasn't why Shakira was there. She had come to confront him, to search his house for proof of the thievery. And when she found it-Simon's own computer messages-Shakira was beyond furious. Her own manager, the very person who had helped her rise to fame, had been working behind her back with Simon.

The rage inside her built, and during her performance, Shakira put her plan into action. She used Simon's remote to turn off the lights in the room, cloaking her movements in darkness. Then, in a swift and final act, she stepped on Simon with her heel. Just as his "step on me" poster suggested, it only took a second, and no one noticed the tiny body."

Duck-tective raises an eyebrow. "What do you think apprentice? Was it worth it? The cost of a life for your dignity?
That's not a verb I recognise.

I beg your pardon?

* * *

>guess super mario
That's not a verb I recognise.

>guess Super Mario
That's not a verb I recognise.

* * *

>guess mario
You accuse Mario, and he gasps in shock. "No! Mamma mia, it wasn't-a me!" he cries, but Duck-tective steps in, smirking.

"Oh, Mario, you thought you could fool us. You and Simon? Childhood friends, yes... but then he got rich, and you stayed poor. Simon treated you like dirt, didn't he?" Duck-tective quips.

Mario shifts uncomfortably as Duck-tective continues, "But then you found out you were cousins-half-cousins, to be exact. You knew Simon's fortune would be yours if he died, so you wrote a fake will from his father to get close, finish him off, and claim the money. When the clock struck midnight, Mario turned of the lights using a remote, jumped on Simon, crushing him, and in the struggle, Simon's life ended."

Mario's face falls, but Duck-tective grins. "Clever, but not clever enough."

As Mario is taken away by the police, Duck-tective looks at you with a quack, "Did you catch the killer? Fortunately, yes. But you still have a lot to learn..."

    *** The End ***

Would you like to RESTART, RESTORE a saved game, QUIT or UNDO the last command?

* * *

>interrogate shrek
Shrek: Well, to be honest, I didn't really like tha" guy. Don't hold it against me, but he was a right rich snob, he was! Aye, I dinnae think he deserved to be killed, but och, he sure knew how t'make a person want t'kill him! Hah! What, did I say somethin" wrong?

>interrogate shakira
Shakira: Ah, cariño, I work in the same industry as Simon, and let me tell you, it's not uncommon to make enemies with some very powerful people. But Dios mío, I never expected this! We used to be close, working together a lot, but not so much lately. Simon and I even did a collab on a song once, back when he was still part of a group. Ay, perdón, I'm still in shock... ¡qué locura! Who in their right mind could have done such a horrible thing?

>n
dining room
The dining room exudes grandeur, with a long, polished oak table set for a feast that never came. Ornate chairs, upholstered in rich velvet, are carefully arranged around it, though one seems hastily pushed back, as if someone stood up abruptly. Crystal chandeliers hang from the ceiling, their glow reflecting off fine china and silverware.

From here you can go east towards the Kitchen, south to the Staff Rooms or west to get to the Grand Hall.

You can see a burger here.

>eat burger
You stuff the burger in your face. You finally understand the hype about Krabby Patties. You won't even care if they're poisoned.

>w
Grand Hall
The centerpiece of the mansion, the grand hall exudes luxury with its gleaming marble floor and an opulent chandelier that sparkles above. Yet, the wide staircase and empty corridors seem to echo with whispers, as if the room itself is watching.

From here you can go west out the back door to the Garden, south towards the Main Entrance, east to the Dining Room or north up stairs towards the Small Hall.

You can see a map, a wooden bat, a flashlight and a suit of armor here.

>take flashlight
Taken.

* * *

>n
dining room
The dining room exudes grandeur, with a long, polished oak table set for a feast that never came. Ornate chairs, upholstered in rich velvet, are carefully arranged around it, though one seems hastily pushed back, as if someone stood up abruptly. Crystal chandeliers hang from the ceiling, their glow reflecting off fine china and silverware.

From here you can go east towards the Kitchen, south to the Staff Rooms or west to get to the Grand Hall.

You can see a burger here.

>w
Grand Hall
The centerpiece of the mansion, the grand hall exudes luxury with its gleaming marble floor and an opulent chandelier that sparkles above. Yet, the wide staircase and empty corridors seem to echo with whispers, as if the room itself is watching.

From here you can go west out the back door to the Garden, south towards the Main Entrance, east to the Dining Room or north up stairs towards the Small Hall.

You can see a map, a wooden bat, a flashlight and a suit of armor here.

>take map
Taken.

>look at map
N
                                                 
                                Simon's room        Library
                                            |                        |
                                            |                        |
                                     Small Hall ------ Living Room ---- Terrace
 W                                        |                                                                        E 
                                            |                         
                  Garden ----Grand Hall --- Dining Room ------ Kitchen
                                            |                       |
                                            |                       |
                               Main Entrance     Staff Room
                                          
                                                         S

>w
Darkness
It is pitch dark, and you can't see a thing.

>e
Grand Hall
The centerpiece of the mansion, the grand hall exudes luxury with its gleaming marble floor and an opulent chandelier that sparkles above. Yet, the wide staircase and empty corridors seem to echo with whispers, as if the room itself is watching.

From here you can go west out the back door to the Garden, south towards the Main Entrance, east to the Dining Room or north up stairs towards the Small Hall.

You can see a wooden bat, a flashlight and a suit of armor here.

>take flashlight
Taken.

* * *

>e
Grand Hall
The centerpiece of the mansion, the grand hall exudes luxury with its gleaming marble floor and an opulent chandelier that sparkles above. Yet, the wide staircase and empty corridors seem to echo with whispers, as if the room itself is watching.

From here you can go west out the back door to the Garden, south towards the Main Entrance, east to the Dining Room or north up stairs towards the Small Hall.

You can see a wooden bat and a suit of armor here.

>n
Small Hall
A narrow passageway connecting the rooms upstairs, the small hall is dimly lit, with worn rugs lining the floor. A faint scuff mark on the wall catches your attention, its origin unknown but undoubtedly suspicious.

From here you can go east to the Living Room, north to enter Simon's room or south down the stairs to the Grand Hall.

>e
Living room
This is the room where it happened. Though the police have removed the body, the faint metallic scent of blood still lingers in the air. The grand furniture and ornate decor now feel cold and uninviting, as if the room itself remembers the crime.

From here you can go north to the Library, west to the Small Hall or east to get to the Terrace.

The fireplace is cold and filled with a layer of ash, the charred remains of logs scattered within. Something faintly catches the eye-barely noticeable amid the soot, as if hiding in plain sight.

You can also see Duck-tective, a mushroom, a spatula, a piano (on which is a sheet music), a stage and a couch here.

>e
terrace
The terrace offers a breathtaking view of the garden below, though the cold night air seems to carry a sense of unease. Elegant wrought-iron furniture is neatly arranged, yet a single chair is overturned, hinting at a moment of panic or a hurried escape.

From here you can go west to the Living room.

You can see a vase of roses here.

>examine vase
A beautiful vase of roses stands on a little stool.

>look under vase
You find a key hidden under the vase.

>examine key
A small key with a rose engraving. It looks like it might fit something special.

>l
terrace
The terrace offers a breathtaking view of the garden below, though the cold night air seems to carry a sense of unease. Elegant wrought-iron furniture is neatly arranged, yet a single chair is overturned, hinting at a moment of panic or a hurried escape.

From here you can go west to the Living room.

You can see a vase of roses here.

>w
Living room
This is the room where it happened. Though the police have removed the body, the faint metallic scent of blood still lingers in the air. The grand furniture and ornate decor now feel cold and uninviting, as if the room itself remembers the crime.

From here you can go north to the Library, west to the Small Hall or east to get to the Terrace.

The fireplace is cold and filled with a layer of ash, the charred remains of logs scattered within. Something faintly catches the eye-barely noticeable amid the soot, as if hiding in plain sight.

You can also see Duck-tective, a mushroom, a spatula, a piano (on which is a sheet music), a stage and a couch here.

>w
Small Hall
A narrow passageway connecting the rooms upstairs, the small hall is dimly lit, with worn rugs lining the floor. A faint scuff mark on the wall catches your attention, its origin unknown but undoubtedly suspicious.

From here you can go east to the Living Room, north to enter Simon's room or south down the stairs to the Grand Hall.

>e
Living room
This is the room where it happened. Though the police have removed the body, the faint metallic scent of blood still lingers in the air. The grand furniture and ornate decor now feel cold and uninviting, as if the room itself remembers the crime.

From here you can go north to the Library, west to the Small Hall or east to get to the Terrace.

The fireplace is cold and filled with a layer of ash, the charred remains of logs scattered within. Something faintly catches the eye-barely noticeable amid the soot, as if hiding in plain sight.

You can also see Duck-tective, a mushroom, a spatula, a piano (on which is a sheet music), a stage and a couch here.

>n
library
A sanctuary of knowledge turned suspicious. The heavy scent of old books and polished wood fills the air, while rows of towering shelves cast long shadows. A grand desk sits in the corner, its surface cluttered with papers that seem oddly out of place, as if someone had been searching for something. Most of the books are dusty, it's obvious they haven't been touched for years. But a couple of them were obviously recently taken from the dusty shelves.

From here you can go south to the Living Room.

You can see a family history book, a document and a folder here.

>look at book
An old, worn book titled "Family Ties and Legacy". It looks like it might contain something important.

>read book
You read: You open the book to find a family tree inside. It shows Simon's lineage, with one name scratched off under "Father". The name is unreadable, and the picture is not shown, but this detail seems significant. Ahh and of course next to Simon's picture there were his brothers, Alvin and Theodore, from whom he was unseparable in his younger days. May their little souls rest in piece.

>s
Living room
This is the room where it happened. Though the police have removed the body, the faint metallic scent of blood still lingers in the air. The grand furniture and ornate decor now feel cold and uninviting, as if the room itself remembers the crime.

From here you can go north to the Library, west to the Small Hall or east to get to the Terrace.

The fireplace is cold and filled with a layer of ash, the charred remains of logs scattered within. Something faintly catches the eye-barely noticeable amid the soot, as if hiding in plain sight.

You can also see Duck-tective, a mushroom, a spatula, a piano (on which is a sheet music), a stage and a couch here.

>w
Small Hall
A narrow passageway connecting the rooms upstairs, the small hall is dimly lit, with worn rugs lining the floor. A faint scuff mark on the wall catches your attention, its origin unknown but undoubtedly suspicious.

From here you can go east to the Living Room, north to enter Simon's room or south down the stairs to the Grand Hall.

>n
Simon's room
Simon's room feels more like a miniature world than a traditional bedroom. Tiny, ornate furniture is arranged with meticulous precision, from a walnut-shell bed lined with silk to a thimble-sized lamp on the nightstand. The air is sweet with the faint scent of acorns, and an open chest in the corner overflows with shiny trinkets and treasures. Despite its charm, a few scattered papers on the floor and a knocked-over stool suggest that not everything was as perfectly in place as it seemed.

From here you can only go south to the Small Hall.

You can see a bed, a mirror, a poster and a computer here.

>examine bed
It's pretty big for a chipmunk...almost the size of a cat's bed. Is there something hidden under it?

>look under bed
You find a photograph here.

>examine photograph
You can't see any such thing.

>examine photo
A photograph of a chipmunk standing next to a female gnome eating a pizza. The writing on the back says, "From Rose to her little brother."

>s
Small Hall
A narrow passageway connecting the rooms upstairs, the small hall is dimly lit, with worn rugs lining the floor. A faint scuff mark on the wall catches your attention, its origin unknown but undoubtedly suspicious.

From here you can go east to the Living Room, north to enter Simon's room or south down the stairs to the Grand Hall.

>s
Grand Hall
The centerpiece of the mansion, the grand hall exudes luxury with its gleaming marble floor and an opulent chandelier that sparkles above. Yet, the wide staircase and empty corridors seem to echo with whispers, as if the room itself is watching.

From here you can go west out the back door to the Garden, south towards the Main Entrance, east to the Dining Room or north up stairs towards the Small Hall.

You can see a wooden bat and a suit of armor here.

>w
Garden
The garden is pristine, every bush and flower meticulously arranged to perfection, as if prepared for a royal visit. The scent of roses and freshly mowed grass lingers in the crisp night air. A majestic fountain sparkles at the center, but nearby, a once-proud marble sculpture lies shattered on the ground, its pieces scattered like a puzzle. The damage looks fresh, and the footprints leading away suggest someone was here-and left in a hurry. From here you can go east to go to the Grand Hall.

From here you can go east to go to the Grand Hall.

You can see a rose bush and a statue here.

>look at bush
A bush with vibrant roses. Looks like something shines behind it.

>look behind bush
There's a small chest there.

>unlock chest with rose key
You turn the rose key in the lock, and with a satisfying click, the chest opens. Inside, you find a letter from Simon's dad.

>read letter
You read:  A letter from his father's will. It says:

To my beloved son Simon,

If you are reading this, it means I am no longer with you. I am sorry for the distance between us, both physical and emotional, over the years. Life has a way of stealing precious time, and I deeply regret the moments we lost.

There is something I must tell you, a truth I kept hidden for your protection. Our family carries a terrible curse. It has haunted our bloodline for generations, striking down many of your ancestors, as it did your brothers. I fear it may be coming for you as well. I beg you to be vigilant, Simon. Guard yourself from harm, and trust no one too easily.

But know this: though the bloodline may be cursed, family is more than blood. You have a half-cousin, Mario, who is tied to our legacy but spared from the curse. He is not of the direct bloodline, but he is family nonetheless. It is my deepest hope that you open your heart to him. His mother Rosie and I were very close in our youth.

If, God forbid, the curse claims you as well, it is my wish that Mario takes over our estate, our property, and everything that was meant to be yours. He is the only one I trust to honor our family's name and ensure its legacy survives beyond this curse.

Simon, you are stronger than you know. But remember, strength alone cannot undo the forces that conspire against us. Be careful, my son. My love and my hopes will remain with you, always.

With all my love, Your Father

Wow... a curse? Half-cousin? Who could have predicted this one? So all of Simon's property belongs to Mario now... very interesting... I wonder if Mario ever found out about this.

>e
Grand Hall
The centerpiece of the mansion, the grand hall exudes luxury with its gleaming marble floor and an opulent chandelier that sparkles above. Yet, the wide staircase and empty corridors seem to echo with whispers, as if the room itself is watching.

From here you can go west out the back door to the Garden, south towards the Main Entrance, east to the Dining Room or north up stairs towards the Small Hall.

You can see a wooden bat and a suit of armor here.

>e
dining room
The dining room exudes grandeur, with a long, polished oak table set for a feast that never came. Ornate chairs, upholstered in rich velvet, are carefully arranged around it, though one seems hastily pushed back, as if someone stood up abruptly. Crystal chandeliers hang from the ceiling, their glow reflecting off fine china and silverware.

From here you can go east towards the Kitchen, south to the Staff Rooms or west to get to the Grand Hall.

You can see a burger here.

* * *

>interrogate mario
Super Mario: Oh mamma mia, che incubo! He was like-a my brother, you know... or-a at least... nevermind. I still can't-a believe what-a happened! Me and Simon, we got-a closer after-a his brothers died. He was lonely, needed a friend, so I-a stepped up, you know? It wasn't-a me! Oh povero Simon! I was-a just going to...no, why-a would I ever-a hurt him?!

>ask mario about letter
There is no reply.

>s
You can't go that way.

>n
dining room
The dining room exudes grandeur, with a long, polished oak table set for a feast that never came. Ornate chairs, upholstered in rich velvet, are carefully arranged around it, though one seems hastily pushed back, as if someone stood up abruptly. Crystal chandeliers hang from the ceiling, their glow reflecting off fine china and silverware.

From here you can go east towards the Kitchen, south to the Staff Rooms or west to get to the Grand Hall.

You can see a burger here.

* * *

>interrogate mario
You begin questioning Super Mario.
Mario: I-a didn't know about-a any letter! Mamma mia! You're telling me Simon and I were family? How did I-a not know this-a? Sorry, I'm-a little confused. Does that mean I'm no longer a suspect? I would never hurt my own family! You gotta believe me, amico!

>interrogate mario
You begin questioning Super Mario.
Mario: I-a didn't know about-a any letter! Mamma mia! You're telling me Simon and I were family? How did I-a not know this-a? Sorry, I'm-a little confused. Does that mean I'm no longer a suspect? I would never hurt my own family! You gotta believe me, amico!

>n
dining room
The dining room exudes grandeur, with a long, polished oak table set for a feast that never came. Ornate chairs, upholstered in rich velvet, are carefully arranged around it, though one seems hastily pushed back, as if someone stood up abruptly. Crystal chandeliers hang from the ceiling, their glow reflecting off fine china and silverware.

From here you can go east towards the Kitchen, south to the Staff Rooms or west to get to the Grand Hall.

You can see a burger here.

>look at burger
Someone took only one bite of this Krabby Patty. I wonder if it was poisoned or simply bad.

>eat burger
You stuff the burger in your face. You finally understand the hype about Krabby Patties. You won't even care if they're poisoned.

>s
Staff Room
A small, functional room where the staff can catch their breath. The furniture is sparse-just a couple of old chairs and a cluttered table with papers scattered across it. The air feels thick with unease as all the suspects have been brought here until the investigation is over. They sit in silence, each one lost in their thoughts, glancing nervously at each other. After you gather up the initial information, you can ask them about the clues you find to get information about it.

Go ahead and interrogate the suspects!

From here you can go north to the Dining Room.

You can see Shrek the ogre, Super Mario, SpongeBob, Smurfette and Shakira here.

* * *

>interrogate spongebob
You begin questioning SpongeBob.
SpongeBob: Ah, so you've tried the old Krabby Patty! Glad to have a new costumer! Sorry, I can't tell you the recipe. It's a secret.

>interrogate mario
You begin questioning Super Mario.
Mario: I-a didn't know about-a any letter! Mamma mia! You're telling me Simon and I were family? How did I-a not know this-a? Sorry, I'm-a little confused. Does that mean I'm no longer a suspect? I would never hurt my own family! You gotta believe me, amico!

>guess shrek
You accuse Shrek, and Duck-tective rolls his eyes.

"Shrek found out Mario was behind a project destroying his beloved swamp, so he set off to avenge his home. Armed with a wooden bat, he arrived at Simon's house, ready to wreak havoc. He started by smashing a statue in the garden when Simon opened the door. Realizing the trouble he was in, Simon invited Shrek to the party, trying to calm him down. Shrek, though furious, eased up a little after a few Krabby Patties."

"But things took a turn when Shrek snooped around Simon's house and found a document confirming the project was already set in motion, claiming minimal environmental impact. Enraged by the deceit, Shrek couldn't hold back. At the party, in front of everyone, he stomped down hard on Simon, crushing him completely. No one even noticed as his tiny body was crushed underfoot." "Shrek just stood there, panting. His face twisted in frustration. "I couldn't let him get away with it. He was ruin" everything... ma family... ma swamp," Shrek muttered to himself, rubbin" his brow. "But now... now it's safe. Too bad it had to end like this."

Duck-tective lets out a long sigh. "A sad way for things to end…but that is the tragic way of life."

    *** The End ***

Would you like to RESTART, RESTORE a saved game, QUIT or UNDO the last command?